Play=Play
Achievements=Achievements
Unlocks=Unlocks
Settings=Settings
Calibrate Finger=Calibrate Finger
Credits=Credits
Language=Language
Music=Music
Sound EFX=Sound EFX
Levels=Levels
Calibrate finger=Calibrate finger
LARGE=LARGE
MEDIUM=MEDIUM
SMALL=SMALL
XL=XL
Achievements and Stats=Achievements and Stats
Statistics=Statistics
PAUSE=PAUSE
RESET=RESET
HINT (GOAL)=HINT (GOAL)
Back=Back
PAUSE MENU=PAUSE MENU
RESUME=RESUME
MAIN MENU=MAIN MENU

NormalKill=Normal Kill
PerfectKill=Perfect Kill

Off=Off
On=On

PandaDead=Panda Dead
FinalScore=Your final score
Lose=You let a panda escape!
NewHighscore=New Highscore!
TotalScore=Total Score
SlobbyKill=Slobby Kill
ComboKill=Combo Kill

TotalScore=Total Score

Combo=x Combo
Time=Time

Calibrate Finger=Calibrate Finger

Sausage=Sausage
Princess=Princess
Child=Child
Hammer=Hammer

Select=Select

LEVELS=LEVELS
MAIN MENU=MAIN MENU
HINTGOAL=HINT (GOAL)
RESUME=RESUME
PAUSED=PAUSED

First kill=First kill
kill your first panda=kill your first panda
Getting the hang of this=Getting the hang of this
Kill 10 pandas=Kill 10 pandas
Fun Times=Fun Times
Kill 50 pandas=Kill 50 pandas
Serial Killah=Serial Killah
Kill 100 pandas=Kill 100 pandas
Massmurdah=Massmurdah
Kill 200 pandas=Kill 200 pandas
Exterminator=Exterminator
Kill 1600 pandas=Kill 1600 pandas
High-Five=High-Five
Slap your first panda=Slap your first panda
Happy Slapper=Happy Slapper
Slap 10 pandas=Slap 10 pandas
Red finger=Red finger
Slap 100 Pandas=Slap 100 Pandas
Mosquito=Mosquito
Collect 5 liters of blood=Collect 5 liters of blooooood
Bloody Mary=Bloody Mary
collect 20 liters of blood=collect 20 liters of blood
Blood sucker=Blood sucker
Collect 50 liters of blood=Collect 50 liters of blood
Dracula=Dracula
Collect 100 liters of blood=Collect 100 liters of blood
Star hunter=Star hunter
Collect all stars=Collect all stars
Combo noob=Combo noob
Get you first combo kill=Get you first combo kill
Combo crazy=Combo crazy
Get 30 combo kills=Get 30 combo kills
Combo king=Combo king
Get 60 combo kills=Get 60 combo kills
Shock therapy=Shock therapy
Kill 50 pandas on shock traps=Kill 50 pandas on shock traps
Pretty Panda Pieces!=Pretty Panda Pieces!
Kill 50 pandas on roundsaw traps=Kill 50 pandas on roundsaw traps
Meat poudin!=Meat poudin!
Kill 50 pandas on Pounder traps=Kill 50 pandas on Pounder traps
Ninja Skills=Ninja Skills
Kill 50 pandas on Throwing star traps=Kill 50 pandas on Throwing star traps
Voodoo=Voodoo
Kill 50 pandas on spikes=Kill 50 pandas on spikes
Panda Hudini=Panda Hudini
Let 30 pandas escape=Let 30 pandas escape

Total amount of slaps=Total amount of slaps
Lifetime score collected=Lifetime score collected
Games played=Games played
Pandas killed=Pandas killed
Perfect kills=Perfect kills
Favourite trap=Favourite trap
Killed on Spikes=Killed on Spikes
Killed on Throwing Stars=Killed on Throwing Stars
Killed on Pounders=Killed on Pounders
Killed on Electricity=Killed on Electricity
Killed on Round Saw=Killed on Round Saw
Blood collected=Blood collected
Total combo kills=Total combo kills

